################################################################################
#@@@@@@@@@@@@@@@@@@@@@.........................................................#
#................@@@@@@@@@@@@@@@...............................................#
#..............................................................................#
#..............................................................................#
#.........................................@@...................................#
#...............@@@.....@@@....................................................#
#.............@@......@@@...@@.........@@@.....................................#
#.................@@.......................@@@@................................#
#.......................@@@...@@...............................................#
#............................@........@@@......................................#
#............@@@@@.............................@@@@............................#
#..............................................................................#
#...........@@@....................@@@.............@@@.........................#
#..........@@@@.........@@@@@@@................................................#
#.................................................@@@@.........................#
#..............................................................................#
#..............................................................................#
#..............................................................................#
################################################################################
