#############################################################################################
#............................................@@.............................................#
#..............................@.............@@...........@@@...@@@.........................#
#.........@@@................@..@..........@@...............................................#
#............................@..@..........@@...........@....@.@....@.......................#
#.............................@.........................@....@.@....@...........@...........#
#.......................................................@....@.@....@.............@.........#
#.........................................................@@@...@@@............@@..@@@......#
#...........................................................................................#
#.........................................................@@@...@@@.........................#
#.......................................................@....@.@....@.......................#
#.......................................................@....@.@....@.......................#
#.......................................................@....@.@....@.......................#
#...........................................................................................#
#.................................@@......................@@@...@@@.........................#
#............@@..................@.@........................................................#
#...........@.@....................@........................................................#
#.............@.............................................................................#
#.........................@.................................................................#
#..........................@................................................................#
#........................@@@................................................................#
#...........................................................................................#
#...........................................................................................#
#...........................................................................................#
#...........................................................................................#
#############################################################################################
