############
#..........#
#..........#
#..........#
#...@@@....#
#..........#
#..........#
############
